Values|County in which data represents
ADAIR COUNTY|ADAIR COUNTY
ALFALFA COUNTY|ALFALFA COUNTY
ATOKA COUNTY|ATOKA COUNTY
BEAVER COUNTY|BEAVER COUNTY
BECKHAM COUNTY|BECKHAM COUNTY
BLAINE COUNTY|BLAINE COUNTY
BRYAN COUNTY|BRYAN COUNTY
CADDO COUNTY|CADDO COUNTY
CANADIAN COUNTY|CANADIAN COUNTY
CARTER COUNTY|CARTER COUNTY
CHEROKEE COUNTY|CHEROKEE COUNTY
CHOCTAW COUNTY|CHOCTAW COUNTY
CIMARRON COUNTY|CIMARRON COUNTY
CLEVELAND COUNTY|CLEVELAND COUNTY
COAL COUNTY|COAL COUNTY
COMANCHE COUNTY|COMANCHE COUNTY
COTTON COUNTY|COTTON COUNTY
CRAIG COUNTY|CRAIG COUNTY
CREEK COUNTY|CREEK COUNTY
CUSTER COUNTY|CUSTER COUNTY
DELAWARE COUNTY|DELAWARE COUNTY
DEWEY COUNTY|DEWEY COUNTY
ELLIS COUNTY|ELLIS COUNTY
GARFIELD COUNTY|GARFIELD COUNTY
GARVIN COUNTY|GARVIN COUNTY
GRADY COUNTY|GRADY COUNTY
GRANT COUNTY|GRANT COUNTY
GREER COUNTY|GREER COUNTY
HARMON COUNTY|HARMON COUNTY
HARPER COUNTY|HARPER COUNTY
HASKELL COUNTY|HASKELL COUNTY
HUGHES COUNTY|HUGHES COUNTY
JACKSON COUNTY|JACKSON COUNTY
JEFFERSON COUNTY|JEFFERSON COUNTY
JOHNSTON COUNTY|JOHNSTON COUNTY
KAY COUNTY|KAY COUNTY
KINGFISHER COUNTY|KINGFISHER COUNTY
KIOWA COUNTY|KIOWA COUNTY
LATIMER COUNTY|LATIMER COUNTY
LE FLORE COUNTY|LE FLORE COUNTY
LINCOLN COUNTY|LINCOLN COUNTY
LOGAN COUNTY|LOGAN COUNTY
LOVE COUNTY|LOVE COUNTY
MAJOR COUNTY|MAJOR COUNTY
MARSHALL COUNTY|MARSHALL COUNTY
MAYES COUNTY|MAYES COUNTY
MCCLAIN COUNTY|MCCLAIN COUNTY
MCCURTAIN COUNTY|MCCURTAIN COUNTY
MCINTOSH COUNTY|MCINTOSH COUNTY
MURRAY COUNTY|MURRAY COUNTY
MUSKOGEE COUNTY|MUSKOGEE COUNTY
NOBLE COUNTY|NOBLE COUNTY
NOWATA COUNTY|NOWATA COUNTY
OKFUSKEE COUNTY|OKFUSKEE COUNTY
OKLAHOMA COUNTY|OKLAHOMA COUNTY
OKMULGEE COUNTY|OKMULGEE COUNTY
OSAGE COUNTY|OSAGE COUNTY
OTTAWA COUNTY|OTTAWA COUNTY
PAWNEE COUNTY|PAWNEE COUNTY
PAYNE COUNTY|PAYNE COUNTY
PITTSBURG COUNTY|PITTSBURG COUNTY
PONTOTOC COUNTY|PONTOTOC COUNTY
POTTAWATOMIE COUNTY|POTTAWATOMIE COUNTY
PUSHMATAHA COUNTY|PUSHMATAHA COUNTY
ROGER MILLS COUNTY|ROGER MILLS COUNTY
ROGERS COUNTY|ROGERS COUNTY
SEMINOLE COUNTY|SEMINOLE COUNTY
SEQUOYAH COUNTY|SEQUOYAH COUNTY
STEPHENS COUNTY|STEPHENS COUNTY
TEXAS COUNTY|TEXAS COUNTY
TILLMAN COUNTY|TILLMAN COUNTY
TULSA COUNTY|TULSA COUNTY
WAGONER COUNTY|WAGONER COUNTY
WASHINGTON COUNTY|WASHINGTON COUNTY
WASHITA COUNTY|WASHITA COUNTY
WOODS COUNTY|WOODS COUNTY
WOODWARD COUNTY|WOODWARD COUNTY
DALLAM COUNTY|DALLAM COUNTY
SHERMAN COUNTY|SHERMAN COUNTY
HANSFORD COUNTY|HANSFORD COUNTY
OCHILTREE COUNTY|OCHILTREE COUNTY
LIPSCOMB COUNTY|LIPSCOMB COUNTY
HEMPHILL COUNTY|HEMPHILL COUNTY
WHEELER COUNTY|WHEELER COUNTY
COLLINGSWORTH COUNTY|COLLINGSWORTH COUNTY
CHILDRESS COUNTY|CHILDRESS COUNTY
HARDEMAN COUNTY|HARDEMAN COUNTY
WILBARGER COUNTY|WILBARGER COUNTY
WICHITA COUNTY|WICHITA COUNTY
CLAY COUNTY|CLAY COUNTY
MONTAGUE COUNTY|MONTAGUE COUNTY
COOKE COUNTY|COOKE COUNTY
GRAYSON COUNTY|GRAYSON COUNTY
FANNIN COUNTY|FANNIN COUNTY
LAMAR COUNTY|LAMAR COUNTY
RED RIVER COUNTY|RED RIVER COUNTY
BOWIE COUNTY|BOWIE COUNTY
MORTON COUNTY|MORTON COUNTY
STEVENS COUNTY|STEVENS COUNTY
SEWARD COUNTY|SEWARD COUNTY
MEADE COUNTY|MEADE COUNTY
CLARK COUNTY|CLARK COUNTY
BARBER COUNTY|BARBER COUNTY
SUMNER COUNTY|SUMNER COUNTY
COWLEY COUNTY|COWLEY COUNTY
CHAUTAUQUA COUNTY|CHAUTAUQUA COUNTY
MONTGOMERY COUNTY|MONTGOMERY COUNTY
LABETTE COUNTY|LABETTE COUNTY
BACA COUNTY|BACA COUNTY
LAS ANIMAS COUNTY|LAS ANIMAS COUNTY
UNION COUNTY|UNION COUNTY
BENTON COUNTY|BENTON COUNTY
CRAWFORD COUNTY|CRAWFORD COUNTY
SEBASTAIN COUNTY|SEBASTAIN COUNTY
SCOTT COUNTY|SCOTT COUNTY
POLK COUNTY|POLK COUNTY
SEVIER COUNTY|SEVIER COUNTY
LITTLE RIVER COUNTY|LITTLE RIVER COUNTY
MCDONALD COUNTY|MCDONALD COUNTY
NEWTON COUNTY|NEWTON COUNTY