Values|Type of place in which data represents
AIRCRAFT|AIRCRAFT
AIRPORT|AIRPORT
ARENA|ARENA
AUTOMOBILE|AUTOMOBILE
BANK|BANK
BAR|BAR
BICYCLE|BICYCLE
BUS|BUS
BUS-STATION|BUS-STATION
CAFE|CAFE
CLASSROOM|CLASSROOM
CLUB|CLUB
CONSTRUCTION|CONSTRUCTION
CONVENTION-CENTER|CONVENTION-CENTER
GOVERNMENT|GOVERNMENT
HOSPITAL|HOSPITAL
HOTEL|HOTEL
INDUSTRIAL|INDUSTRIAL
LIBRARY|LIBRARY
MOTORCYCLE|MOTORCYCLE
OFFICE|OFFICE
OTHER|OTHER
OUTDOORS|OUTDOORS
PARKING|PARKING
PLACE-OF-WORSHIP|PLACE-OF-WORSHIP
PRISON|PRISON
PUBLIC|PUBLIC
PUBLIC-TRANSPORT|PUBLIC-TRANSPORT
RESIDENCE|RESIDENCE
RESTAURANT|RESTAURANT
SCHOOL|SCHOOL
SHOPPING-AREA|SHOPPING-AREA
STADIUM|STADIUM
STORE|STORE
STREET|STREET
THEATER|THEATER
TRAIN|TRAIN
TRAIN-STATION|TRAIN-STATION
TRUCK|TRUCK
UNDERWAY|UNDERWAY
UNKNOWN|UNKNOWN
WAREHOUSE|WAREHOUSE
WATER|WATER
WATERCRAFT|WATERCRAFT