Values|Identifier of street type used in a complete street name
ALLEY|ALLEY
ANNEX|ANNEX
ARCADE|ARCADE
AVENUE|AVENUE
BAYOU|BAYOU
BEACH|BEACH
BEND|BEND
BLUFF|BLUFF
BLUFFS|BLUFFS
BOTTOM|BOTTOM
BOULEVARD|BOULEVARD
BRANCH|BRANCH
BRIDGE|BRIDGE
BROOK|BROOK
BROOKS|BROOKS
BURG|BURG
BURGS|BURGS
BYPASS|BYPASS
CAMP|CAMP
CANYON|CANYON
CAPE|CAPE
CAUSEWAY|CAUSEWAY
CENTER|CENTER
CENTERS|CENTERS
CIRCLE|CIRCLE
CIRCLES|CIRCLES
CLIFF|CLIFF
CLIFFS|CLIFFS
CLUB|CLUB
COMMON|COMMON
COMMONS|COMMONS
CORNER|CORNER
CORNERS|CORNERS
COURSE|COURSE
COURT|COURT
COURTS|COURTS
COVE|COVE
COVES|COVES
CREEK|CREEK
CRESCENT|CRESCENT
CREST|CREST
CROSSING|CROSSING
CROSSROAD|CROSSROAD
CROSSROADS|CROSSROADS
CURVE|CURVE
DALE|DALE
DAM|DAM
DIVIDE|DIVIDE
DRIVE|DRIVE
DRIVES|DRIVES
ESTATE|ESTATE
ESTATES|ESTATES
EXPRESSWAY|EXPRESSWAY
EXTENSION|EXTENSION
EXTENSIONS|EXTENSIONS
FALL|FALL
FALLS|FALLS
FERRY|FERRY
FIELD|FIELD
FIELDS|FIELDS
FLAT|FLAT
FLATS|FLATS
FORD|FORD
FORDS|FORDS
FOREST|FOREST
FORGE|FORGE
FORGES|FORGES
FORK|FORK
FORKS|FORKS
FORT|FORT
FREEWAY|FREEWAY
GARDEN|GARDEN
GARDENS|GARDENS
GATEWAY|GATEWAY
GLEN|GLEN
GLENS|GLENS
GREEN|GREEN
GREENS|GREENS
GROVE|GROVE
GROVES|GROVES
HARBOR|HARBOR
HARBORS|HARBORS
HAVEN|HAVEN
HEIGHTS|HEIGHTS
HIGHWAY|HIGHWAY
HILL|HILL
HILLS|HILLS
HOLLOW|HOLLOW
INLET|INLET
ISLAND|ISLAND
ISLANDS|ISLANDS
ISLE|ISLE
JUNCTION|JUNCTION
JUNCTIONS|JUNCTIONS
KEY|KEY
KEYS|KEYS
KNOLL|KNOLL
KNOLLS|KNOLLS
LAKE|LAKE
LAKES|LAKES
LAND|LAND
LANDING|LANDING
LANE|LANE
LIGHT|LIGHT
LIGHTS|LIGHTS
LOAF|LOAF
LOCK|LOCK
LOCKS|LOCKS
LODGE|LODGE
LOOP|LOOP
MALL|MALL
MANOR|MANOR
MANORS|MANORS
MEADOW|MEADOW
MEADOWS|MEADOWS
MEWS|MEWS
MILL|MILL
MILLS|MILLS
MISSION|MISSION
MOTORWAY|MOTORWAY
MOUNT|MOUNT
MOUNTAIN|MOUNTAIN
MOUNTAINS|MOUNTAINS
NECK|NECK
ORCHARD|ORCHARD
OVAL|OVAL
OVERPASS|OVERPASS
PARK|PARK(S)
PARKWAY|PARKWAY(S)
PASS|PASS
PASSAGE|PASSAGE
PATH|PATH
PIKE|PIKE
PINE|PINE
PINES|PINES
PLACE|PLACE
PLAIN|PLAIN
PLAINS|PLAINS
PLAZA|PLAZA
POINT|POINT
POINTS|POINTS
PORT|PORT
PORTS|PORTS
PRAIRIE|PRAIRIE
RADIAL|RADIAL
RAMP|RAMP
RANCH|RANCH
RAPID|RAPID
RAPIDS|RAPIDS
REST|REST
RIDGE|RIDGE
RIDGES|RIDGES
RIVER|RIVER
ROAD|ROAD
ROADS|ROADS
ROUTE|ROUTE
ROW|ROW
RUE|RUE
RUN|RUN
SHOAL|SHOAL
SHOALS|SHOALS
SHORE|SHORE
SHORES|SHORES
SKYWAY|SKYWAY
SPRING|SPRING
SPRINGS|SPRINGS
SPUR|SPUR(S)
SQUARE|SQUARE
SQUARES|SQUARES
STATION|STATION
STRAVENUE|STRAVENUE
STREAM|STREAM
STREET|STREET
STREETS|STREETS
SUMMIT|SUMMIT
TERRACE|TERRACE
THROUGHWAY|THROUGHWAY
TRACE|TRACE
TRACK|TRACK
TRAFFICWAY|TRAFFICWAY
TRAIL|TRAIL
TRAILER|TRAILER
TUNNEL|TUNNEL
TURNPIKE|TURNPIKE
UNDERPASS|UNDERPASS
UNION|UNION
UNIONS|UNIONS
VALLEY|VALLEY
VALLEYS|VALLEYS
VIADUCT|VIADUCT
VIEW|VIEW
VIEWS|VIEWS
VILLAGE|VILLAGE
VILLAGES|VILLAGES
VILLE|VILLE
VISTA|VISTA
WALK|WALK(S)
WALL|WALL
WAY|WAY
WAYS|WAYS
WELL|WELL
WELLS|WELLS